# # # # # # # # # # # # # # # # # # # # # #
# + - - - - - - - - - - - - - - - - - - - #
# - - - - - - - - - - - - - - - - - - - - #
# - - - - - - - - - - - - - - - - - - - - #
# # # # # # # # # # # - - - - S - - - - - #
# - - - - - - - - - - - - - - - - - - - - #
# - - - - - - - - - - - - - - - - - - - - #
# - - - - - - - - - - - - - - - - - - - - #
# - - - - - - - - - - - - - - - - - - - - #
# - - - - - - - - - - - - - - - - - - - - #
# - - - - - - - - - - - - - - - - - - - - #
# - - - - - # # # # # # # # # # # # - - - #
# - - - - - - - - - - - - - - - - - - - - #
# - - - - - - - - - - - - - - - - - - - - #
# - - - - - - - - - - - - - - - - - - - - #
# - - - - - - - - - - - - - - - - - - - - #
# - - - - - - - - - - - - - - - - - - - - #
# - - - - - - - - - - - - - - - - - - - - #
# - - - - - - - - - - - - - - - - - - - - #
# - - - - - - - - - - - - - - - - - - - - #
# - - - - - - - - - - - - - - - - - - - - #
# - - - - - - - - - # # # # # # # # # # # #
# - - - - - - - - - - - - - - - - - - - - #
# - - - - - - - - - - - - - - - - - - - - #
# - - - - - - - - - - - - - - - - - - - - #
# - - - - - - - - - # # # # # # # # # # # #
# - - - - - - - - - - - - - - - - - - - - #
# - - - - - - - - - - - - - - - - - - - - #
# - - - - - - - - - - - - - - - - - - - - #
# - - - - - - - - - - - - - - - - - - - - #
# - - - - - - - - - - - - - - - - - - - - #
# - - - - - - - - - - - - - - - - - - - - #
# - - - - - - - - - - - - - - - - - - - - #
# - - - - - - - - - - - - - - - - - - - - #
# - - - - - - - - - - - - - - - - - - - - #
# - - - - - - - - - - - - - - - - - - - - #
# - - - - - - - - - - - - - - - - - - - - #
# - - - - - - - - - - - - - - - - - - - - #
# - - - - - - - - - - - - - - - - - - - - #
# - - - - - - - - - - - - - - - - - - - - #
