# # # # # # # # # # # # # # # # # # # # # #
# - - - - - - - - - - - - - - - - - - - - #
# - + - - - - - - - - - - - - - - - - - - #
# - - - - - - - - - - - - - - - - - - - - #
# - - - - - - - - - - - - - - - - - - - - #
# - - - - - - - - - - - - - - - - - - - - #
# - - - - - - - - - - - - - - - - - - - - #
# - - - - - - - - - - - - - - - - - - - - #
# - - - - - - - - - - - - - - - - - - - - #
# - - - - - - - - - - - - - - - - - - - - #
# - - - - - - - - - - - - - - - - - - - - #
# - - - - - - - - - - - - - - - - - - - - #
# - - - - - - - - - - - - - - - - - - - - #
# - - - - - - - - - - - - - - - - - - - - #
# - - - - - - - - - - - - - - - - - - - - #
# - - - - - - - - - - - - - - - - - - - - #
# - - - - - - - - - - - - - - - - - - - - #
# - - - - - - - - - - - - - - - - - - - - #
# - - - - - - - - - - - - - - - - - - - - #
# # # # # # # # # # # # - - - - - - - - - #
# - - - - - - - - - - - - - - - - - - - - #
# - - - - - - - - - - - - - - - - - - - - #
# - - - - - - - - - - - - - - - - - - - - #
# - - - - - - - - - - & & & & & - - - - - #
# - - - - - - - - - - - - - - - - - - - - #
# - - - - - - - - - - - - - - - - - - - - #
# - - - - - - - - - - - - - - - - - - - - #
# - - - - - - - - - - - - - - - - - - - - #
# - - - - - - - - - - - - - - - - - - - - #
# - - - - - - - - - - # # # # # # # # # # #
# - - - - - - - - - - - - - - - - - - - - #
# - - - - - - - - - - - - - - - - - - - - #
# - - - - - - - - - - - - - - - - - - - - #
# - - - - - - - - - - - - - - - - - - - - #
# - - - - - - - - - - - - - - - - - - - - #
# - - - - - - - - - - - - - - - - - - - - #
# - - - - - - - - - - - - - - - - - - - - #
# # # # # # # # # # - - # # # # # # # # # #
# - - - - - - - - - - - - - - - - - - - - #
# - - - - - - - - - - - - - - - - - - - - #
# - - - - - - - - - - - - - - - - - - - - #
# - - - - - - - - - - - - - - - - - - - - #
# - - - - - - - - - - - - - - - - - - - - #
# - - - - - - - - - - - - - - - - - - - - #
# - - - - - - - - - - - - - - - - - - - - #
# - - - - - - - - - - - - - - - - - - - - #
# # # # # # # # # # # # # # # # # # - - - #
# - - - - - - - - - - - - - - - - - - - - #
# - - - - - - - - - - - - - - - - - - - - #
# - - - - - - - - - - - - - - - - - - - - #
# - - - - - - - - - - - - - - - - - - - - #
# - - - - - - - - - - - - - - - - - - - - #
# - - - - - - - - - - - - - - - - - - - - #
# - - - - - - - - - - - - - - - - - - - - #
# - - - - - - - - - - - - - - - - - - - - #
# - - - - - - - - - - - - - - - - - - - - #
# - - - - - - - - - - - - - - - - - - - - #
# - - - # # # # # # # # # # # # # # # # # #
# - - - - - - - - - - - - - - - - - - - - #
# - - - - - - - - - - - - - - - - - - - - #
# - - - - - - - - - - - - - - - - - - - - #
# - - - - - - - - - - - - - - - - - - - - #
# - - - - - - - - - - - - - - - - - - - - #
# - - - - - - - - - - - - - - - - - - - - #
# - - - - - - - - - - - - - - - - - - - - #
# - - - - - - - - - - - - - - - - - - - - #
# # # # # # # # # # # # # # # # # # - - - #
# - - - - - - - - - - - - - - - - - - - - #
# - - - - - - - - - - - - - - - - - - - - #
# - - - - - - - - - - - - - - - - - - - - #
# - - - - - - - - - - - - - - - - - - - - #
# - - - - - - - - - - - - - - - - - - - - #
# - - - - - - - - - - - - - - - - - - - - #
# - - - - - - - - - - - - - - - - - - - - #
# - - - # # # # # # # # # # # # # # # # # #
# - - - - - - - - - - - - - - - - - - - - #
# - - - - - - - - - - - - - - - - - - - - #
# - - - - - - - - - - - - - - - - - - - - #
# - - - - - - - - - - - - - - - - - - - - #
# - - - - - - - - - - - - - - - - - - - - #
# - - - - - - - - - - - - - - - - - - - - #
# - - - - - - - - - - - - - - - - - - - - #
# - - - - - - - - - - - - - - - - - - - - #
# - - - - - - - - - - - - - - - - - - - - #
# - - - - - - - - - - - - - - - - - - - - #
# - - - - - - - - - - - - - - - - - - - - #
# - - - - - - - - - - - - - - - - - - - - #
# - - - - - - - - - - - - - - - - - - - - #
