# # # # # # # # # # # - - - - - - - - - - -
# + - - - - - - - - - - - - - - - - - - - -
- - - - - - - - - - - - - - - - - - - - - -
- - - - - - - - - - - - - - - - - - - - - -
# # # # # # # # # # # - - - - S - - - - - -
# - - - - - - - - - - - - - - - - - - - - -
# - - - - - - - - - - - - - - - - - - - - -
# - - - - - - - - - - - - - - - - - - - - #
# - - - - - - - - - - - - - - - - - - - - #
# - - - - - - - - - - - - - - - - - - - - #
# - - - - - - - - - - - - - - - - - - - - #
# - - - - - # # # # # # # # # # # # - - - #
# - - - - - - - - - - - - - - - - - - - - #
# - - - - - - - - - - - - - - - - - - - - #
# - - - - - - - - - - - - - - - - - - - - #
# - - - - - - - - - - - - - - - - - - - - #
# - - - - - - - - - - - - - - - - - - - - #
# - - - - - - - - - - - - - - - - - - - - #
# - - - - - - - - - - - - - - - - - - - - #
# - - - - - - - - - - - - - - - - - - - - #
# - - - - - - - - - - - - - - - - - - - - #
# - - - - - - - - - # # # # # # # # # # # #
# - - - - - - - - - - - - - - - - - - - - #
# - - - - - - - - - - - - - - - - - - - - #
# - - - - - - - - - - - - - - - - - - - - #
# - - - - - - - - - # # # # # # # # # # # #
# - - - - - - - - - - - - - - - - - - - - #
# - - - - - - - - - - - - - - - - - - - - #
# - - - - - - - - - - - - - - - - - - - - #
# - - - - - - - - - - - - - - - - - - - - #
# - - - - - - - - - - - - - - - - - - - - #
# - - - - - - - - - - - - - - - - - - - - #
# - - - - - - - - - - - - - - - - - - - - #
# - - - - - - - - - - - - - - - - - - - - #
# - - - - - - - - - - - - - - - - - - - - #
# - - - - - - - - - - - - - - - - - - - - #
# - - - - - - - - - - - - - - - - - - - - #
# - - - - - - - - - - - - - - - - - - - - #
# - - - - - - - - - - - - - - - - - - - - #
# - - - - - - - - - - - - - - - - - - - - #
